010111011101110111010000000000000-
010101010101010101010000000000000-
010101010101010101010000000000000-
010101010101010101010000000000000-
010101010101010101010000000000000-
010101010101010101010000000000000-
010101010101010101010000000000000-
010101010101010101010000000000000-
011101110111011101110000000000000-
000000000000000000000000000000000-
000000000000000000000000000000000-
000000000000000000000000000000000
